00 00 00 04 00 00 00 00 04 00 00 00 00 00 00 00 00 00 00 00 00 00 04 00 11 16 18 07 07 07 07 07 07 07 07 07 07 07 07 07 07 07 07 07 07 07 07 07 07 07  
00 00 00 00 00 00 00 00 00 00 00 00 00 00 00 04 00 00 00 04 00 00 00 00 00 11 08 08 08 08 08 08 08 08 08 08 08 08 08 08 08 08 08 08 08 08 08 08 08 08  
00 00 00 00 00 04 00 00 00 04 00 00 00 00 00 00 01 01 01 01 01 01 01 01 01 01 01 01 01 01 01 01 01 01 01 01 01 01 01 01 01 01 01 01 01 01 01 01 01 01  
00 00 00 00 00 00 04 04 00 00 00 00 00 01 01 01 03 03 03 03 03 03 03 03 03 03 03 01 05 05 05 05 05 05 05 05 05 05 05 05 05 05 05 05 05 05 05 05 05 04  
00 00 00 00 00 00 00 00 04 00 00 01 01 03 03 03 03 03 01 01 01 01 01 01 01 03 03 03 01 05 05 05 05 05 05 05 05 05 05 05 05 05 05 05 05 05 05 05 05 04  
00 00 00 00 04 00 04 04 00 01 01 03 03 03 03 01 01 01 00 00 00 00 00 00 00 01 01 03 03 01 05 05 05 05 05 05 05 05 05 05 05 05 05 05 05 05 05 05 05 04  
00 00 00 04 00 00 00 01 01 03 03 03 01 01 01 00 00 00 00 00 00 00 00 00 00 00 00 01 03 01 05 05 05 05 05 05 05 05 05 05 05 05 05 05 05 05 05 05 05 04  
00 00 00 00 00 01 01 03 03 03 01 01 00 00 00 00 00 00 00 00 00 00 00 00 00 00 00 01 03 01 05 05 05 05 05 05 05 05 05 05 05 05 05 05 05 05 05 05 05 04  
00 00 00 01 01 03 03 03 01 01 00 00 00 00 00 00 04 00 00 00 00 00 00 00 00 00 00 01 03 01 05 05 05 05 05 05 05 05 05 05 05 05 05 05 05 05 05 05 05 04  
00 01 01 03 03 03 00 00 00 00 00 00 00 00 00 00 00 00 00 00 00 00 00 00 00 00 00 01 03 01 05 05 05 05 05 05 05 05 05 05 05 05 05 05 05 05 05 05 05 04  
01 03 03 03 01 01 01 01 01 01 01 01 01 01 01 01 01 01 01 01 01 01 01 00 00 00 00 01 03 01 05 05 05 05 05 05 05 05 05 05 05 05 05 05 05 05 05 05 05 04 
03 03 01 01 01 01 01 03 03 03 03 03 03 03 03 03 03 03 03 03 03 03 03 01 01 01 00 01 03 01 05 05 05 05 05 05 05 05 05 05 05 05 05 05 05 05 05 05 05 04  
03 01 01 03 03 03 03 03 01 00 01 01 01 01 01 01 01 01 01 01 01 01 03 03 03 03 01 03 01 00 05 05 05 05 05 05 05 05 05 05 05 05 05 05 05 05 05 05 05 04  
03 03 03 03 01 01 01 01 00 00 00 00 00 00 00 00 00 00 00 00 00 00 01 01 01 03 03 03 01 00 05 05 05 05 05 05 05 05 05 05 05 05 05 05 05 05 05 05 05 04  
03 03 01 01 01 01 01 00 00 00 00 00 00 00 00 00 00 00 00 00 00 00 00 00 00 01 03 03 03 00 05 05 05 05 05 05 05 05 05 05 05 05 05 05 05 05 05 05 05 04  
03 03 03 03 03 03 03 01 01 01 01 01 00 00 00 00 00 00 00 00 00 01 01 01 01 03 03 03 01 04 05 05 05 05 05 05 05 05 05 05 05 05 05 05 05 05 05 05 05 04  
03 03 01 01 01 01 03 03 03 03 03 03 01 01 01 01 01 01 01 01 01 03 03 03 03 03 01 03 01 04 05 05 05 00 00 05 05 05 05 05 05 05 05 05 05 05 05 05 05 04 
01 03 03 03 01 01 01 00 01 01 03 03 03 03 03 03 03 03 03 03 03 03 03 03 01 01 01 03 01 00 05 05 00 00 00 00 00 05 05 05 05 05 05 05 05 05 05 05 05 04  
04 01 01 03 03 01 01 00 00 00 01 01 01 01 01 01 01 01 01 01 01 01 01 01 00 00 01 03 03 01 05 05 04 00 04 04 00 00 05 05 05 05 05 05 05 05 05 05 05 04  
04 04 04 01 03 03 03 01 00 00 00 00 00 00 00 00 00 00 00 00 00 00 00 00 00 00 00 01 03 01 05 05 00 03 04 04 04 00 00 05 04 03 05 05 05 05 05 05 05 04 
04 04 04 04 01 01 03 03 03 01 00 00 00 00 00 00 00 00 00 00 00 00 00 00 00 00 00 01 03 01 05 05 04 03 04 04 04 04 04 04 04 03 00 05 03 04 04 04 05 04  
04 04 04 04 04 04 01 01 03 03 01 01 00 00 00 00 00 00 00 00 00 00 00 00 00 00 00 01 03 01 05 05 00 03 04 04 04 03 04 04 04 03 04 04 04 03 04 05 05 04  
04 04 04 04 04 04 04 04 01 03 03 03 01 01 01 00 00 00 00 00 00 00 00 00 00 00 01 03 03 01 05 05 04 03 04 04 04 03 04 04 04 03 04 04 04 04 03 04 04 04  
04 04 04 04 04 04 04 04 04 01 01 03 03 03 03 01 01 01 01 00 00 00 00 00 00 01 01 03 01 04 05 05 04 03 04 03 03 03 03 03 04 03 04 04 04 04 04 03 04 03  
04 04 04 04 04 04 04 04 04 04 04 01 01 03 03 03 03 03 03 01 01 01 01 01 01 03 03 03 01 04 05 05 04 03 04 04 04 03 04 04 04 03 04 04 04 04 03 04 04 03  
04 04 04 04 04 04 04 04 04 04 04 04 04 01 01 01 03 03 03 03 03 03 03 03 03 03 03 01 04 04 05 05 04 03 04 04 04 03 04 04 04 03 04 04 04 03 04 04 04 03  
04 04 04 04 04 04 04 04 04 04 04 04 04 04 04 04 01 01 01 01 01 01 01 01 01 01 01 04 04 04 05 05 00 03 04 04 04 04 04 04 04 03 04 04 03 04 04 04 04 03  
04 04 04 04 04 04 04 04 04 04 04 04 04 04 04 04 04 04 04 04 04 04 04 04 04 04 04 04 04 04 05 05 00 03 04 04 04 04 04 04 04 03 04 04 04 04 04 04 04 03 
05 05 05 05 05 05 05 05 05 05 05 05 05 05 05 05 05 05 05 05 05 05 05 05 05 05 05 05 05 05 05 05 05 05 05 05 04 04 04 04 04 04 04 04 04 04 04 04 04 04  
05 05 05 05 05 05 05 05 05 05 05 05 05 05 05 05 05 05 05 05 05 05 05 05 05 05 05 05 05 05 05 05 05 05 05 05 04 04 04 04 04 05 05 05 05 05 00 00 00 00  
04 00 00 04 00 04 04 04 04 04 04 04 04 04 04 04 04 04 04 04 04 04 04 04 00 04 04 04 04 04 04 04 04 04 05 05 05 05 05 05 05 05 04 04 04 04 04 04 04 04  
04 04 00 00 04 04 04 04 04 04 04 04 04 04 04 04 04 04 04 04 04 04 04 04 00 04 04 04 04 04 04 04 04 04 05 05 05 05 05 04 04 04 04 04 04 04 04 04 04 04  
04 04 00 04 04 00 00 04 04 04 04 04 04 04 04 04 04 04 01 01 01 01 01 01 00 04 04 04 04 04 04 04 01 04 04 04 04 04 04 04 01 04 04 04 01 01 01 04 04 04  
04 00 04 04 04 04 00 04 04 04 04 04 04 04 04 04 04 04 01 04 04 04 04 04 00 04 04 04 04 04 04 04 01 01 00 04 00 00 04 04 01 00 00 01 00 04 00 04 00 01  
04 04 04 04 04 04 00 04 04 04 04 04 04 04 04 04 04 04 01 04 04 04 04 04 00 04 04 04 04 04 04 04 01 04 01 00 04 04 01 04 01 04 00 01 04 00 00 00 01 00  
04 04 04 04 04 04 04 04 04 04 04 04 04 04 04 04 04 04 01 04 04 04 04 04 00 01 01 01 01 01 01 04 01 04 01 00 00 00 01 04 01 04 00 01 04 04 00 00 01 01  
04 04 04 04 04 04 04 04 04 04 04 04 04 04 04 04 04 04 01 04 04 04 04 04 00 04 04 04 04 04 04 04 01 04 01 00 04 00 01 04 01 04 01 04 04 00 04 00 04 00  
04 04 04 00 00 04 04 00 04 00 04 00 04 00 04 04 04 04 01 01 01 01 01 01 00 04 04 00 04 04 00 00 01 00 01 00 04 00 01 00 01 00 01 00 04 04 04 04 04 04  
00 04 00 00 04 00 00 04 04 04 04 00 00 00 04 04 04 04 01 00 00 04 00 00 00 00 04 04 04 00 04 04 01 00 04 01 00 01 00 00 01 04 01 00 04 04 04 00 00 00  
00 00 04 04 00 00 04 00 04 04 00 00 00 04 00 04 00 04 01 00 00 04 04 00 00 01 01 01 01 01 01 04 01 00 04 01 04 01 00 00 01 00 01 00 04 04 00 04 04 04 
04 04 04 04 00 00 04 00 00 00 00 00 00 00 04 04 00 00 01 00 00 04 04 00 00 04 00 04 04 00 04 04 01 04 00 01 00 01 00 00 01 00 00 01 04 00 04 04 04 04  
04 00 00 00 04 04 00 00 04 04 04 00 00 00 04 00 00 00 01 04 00 00 04 00 00 00 00 00 00 00 04 00 01 00 04 01 00 01 00 00 01 00 00 01 04 00 04 00 04 04 
00 00 00 00 00 00 00 00 00 00 00 00 00 00 00 00 00 00 01 00 00 00 00 00 00 00 00 00 00 00 00 00 01 00 00 00 01 00 00 00 01 00 00 01 00 00 00 00 00 04  
00 00 00 00 00 00 00 04 00 00 00 00 00 00 00 00 00 00 01 01 01 01 01 01 00 00 00 00 00 00 00 00 01 00 00 00 01 00 00 00 01 00 00 00 01 01 01 00 00 04  
00 00 00 00 00 00 00 00 00 00 00 00 00 00 00 00 00 00 00 00 04 00 00 00 00 00 04 00 00 00 00 00 00 00 00 00 00 00 00 00 00 00 00 00 00 00 00 00 00 04  
01 01 01 01 01 01 01 01 01 01 01 01 01 01 01 01 01 01 01 01 01 01 01 01 01 01 01 01 01 01 01 01 01 01 01 01 01 01 01 01 01 01 01 01 01 01 01 01 01 01  
04 00 04 04 00 04 00 04 04 04 04 04 04 04 00 04 04 04 04 04 04 04 04 00 04 04 04 04 00 04 04 04 04 04 00 04 04 04 04 00 04 00 04 04 04 04 00 04 04 04 
04 04 04 04 04 00 04 04 04 04 04 04 04 04 00 04 04 00 04 04 04 04 04 04 04 04 04 04 04 04 04 04 04 04 04 04 04 04 00 04 00 04 04 04 04 04 04 04 04 04 
04 04 04 04 04 04 04 04 04 04 04 00 04 04 04 00 04 04 04 04 04 04 04 04 04 04 04 04 04 04 04 04 04 04 04 00 04 04 04 04 04 04 04 04 04 04 00 00 04 04  
04 04 04 04 04 04 04 04 04 04 04 00 04 04 04 04 04 04 04 04 04 04 04 04 04 04 04 04 04 04 04 04 04 04 04 04 04 04 04 04 04 04 04 04 04 04 00 00 04 04 